-12
13
-5
5
00000000000000000000000000
00001111111111111111100000
11111000000000000000100000
10000000000000000000100000
10000000000000000000100000
11111000000000000000100000
00001000000000000000111110
00001000000000000000000010
00001000000000000000000010
00001000000000000000111110
00001111111111111111100000
